NO ./assets/textures/walls/wall_1.xpm
SO ./assets/textures/walls/wall_2.xpm
WE
EA ./assets/textures/walls/wall_4.xpm

F 50,50,50
C 150,150,255

11111111111111111111
10000000000000000001
10000000000000000001
100W1010101010101001
10000000000000000001
10000000000000001001
10000000000000001001
10000000000000001001
10000000000001111001
10000000000000000001
10000000000000000001
10000000000000000001
11111111111111111111