NO ./assets/textures/walls/wall_1.xpm 64,64
SO ./assets/textures/walls/wall_2.xpm 64,64
WE ./assets/textures/walls/wall_3.xpm 64,64
EA ./assets/textures/walls/wall_4.xpm 64,64

F ./assets/textures/floors/sand.xpm 64,64
C ./assets/textures/ceilings/ceiling.xpm 64,64
D ./assets/textures/doors/door.xpm 64,64
E ./assets/textures/entities/flying/flying.xpm 64,64

UI_PAUSE_BG ./assets/textures/ui/backgrounds/bg_transparent_pixels.xpm 297,297
UI_PAUSE_LABEL ./assets/textures/ui/labels/label_pause1.xpm 200,100
UI_PAUSE_BTN_RESUME_OFF ./assets/textures/ui/buttons/btn_resume_off1.xpm 400,100
UI_PAUSE_BTN_RESUME_ON ./assets/textures/ui/buttons/btn_resume_on1.xpm 400,100
UI_PAUSE_BTN_QUIT_OFF ./assets/textures/ui/buttons/btn_quit_off1.xpm 400,100
UI_PAUSE_BTN_QUIT_ON ./assets/textures/ui/buttons/btn_quit_on1.xpm 400,100

111111111111111111111111
100000000000000000000001
100000000000000000011111
100N1010101010101001
10000000000000000001
10000000000000001001
10000000000000e01001
10000000000000001001
101110000000011d1001
10001000000000000011
1000d00000000000001
1000100000000000001
1111111111111111111