NO ./assets/textures/wall_1.xpm
SO ./assets/textures/wall_2.xpm
WE ./assets/textures/wall_3.xpm
EA ./assets/textures/wall_4.xpm

F ./assets/textures/ground.xpm
C ./assets/textures/ceiling.xpm
D ./assets/textures/door.xpm
E ./assets/textures/flying.xpm

11111111111111111111
10000000000000000001
10000000000000000001
100W1010101010101001
100000000s000000000111
100000000000000s100d01
1000000000000000100111
1000000000s000001001
101110000000011d1001
100010000000s0000001
1000d00000000000s001
10001000000000000001
11111111111111111111