NO ./assets/textures/wall_1.xpm
SO ./assets/textures/wall_2.xpm
WE ./assets/textures/wall_3.xpm
EA ./assets/textures/wall_4.xpm

F ./assets/textures/ground.xpm
C ./assets/textures/ceiling.xpm
D ./assets/textures/door.xpm
E ./assets/textures/flying.xpm

11111111111111111111
10000000000000000001
10e00000000000000001
10001010101010101001
10e000000e0000000001
10000000000e000e1001
1000000N000000001001
1000000000e000001001
101110000000011d1001
100010000000e0000001
1000d00000000000e001
10001000000000000001
11111111111111111111