NO ./assets/textures/wall_1.xpm
SO ./assets/textures/wall_2.xpm
WE ./assets/textures/wall_3.xpm
EA ./assets/textures/wall_4.xpm

F ./assets/textures/ground.xpm
C ./assets/textures/ceiling.xpm
D ./assets/textures/door.xpm
E ./assets/textures/flying.xpm

11111111111111111111
10000000000000000001
10e00000000000000001
100N1010101010101001
100000000e0000000001
100000000000000e1001
10000000000000001001
1000000000e000001001
101110000000011d1001
100010000000e0000001
1000d00000000000e001
10001000000000000001
11111111111111111111