NO ./assets/textures/wall_1.xpm
SO ./assets/textures/wall_2.xpm
WE ./assets/textures/wall_3.xpm
EA ./assets/textures/wall_4.xpm

F ./assets/textures/ground.xpm
C ./assets/textures/ceiling.xpm
D ./assets/textures/door.xpm
E ./assets/textures/doom_enemy.xpm

11111111111111111111
10000000000000000001
10000000000000000001
100W1010101010101001
10000000000000000001
10000000000000001001
100000000s0000001001
10000000000000001001
101110000000011d1001
10001000000000000001
1000d000000000000001
10001000000s00000001
11111111111111111111