NO ./assets/textures/wall_1.xpm
SO ./assets/textures/wall_2.xpm
WE ./assets/textures/wall_3.xpm
EA ./assets/textures/wall_4.xpm

F ./assets/textures/ground.xpm
C ./assets/textures/ceiling.xpm
E ./assets/textures/doom_enemy.xpm

11111111111111111111
12222222222222222221
12222222222222222221
122N1212121212121221
12222222222222222221
12222222222222221221
12222222222222221221
12222222222222221221
12222222222221111221
12222222222222222221
12222222222222222221
12222222222222222221
11111111111111111111